0000000000000000000000000000000000000000000000000000000000000000000000000000000000000000000000000000000000000000000000000000000000000000000000000000000000000000000000000000000000000000000000000000000000000000000000
0000000000000000000000000000000000000000000000000000000000000000000000000000000000000000000000000000000000000000000000000000000000000000000000000000000000000000000000000000000000000000000000000000000000000000000000
0000000000900000000000000000000000000000000000000000000000000000000000000000000000000000000s7s700000000000000000000000000000000000000000000000000000000000000000000000000000000000000000000000000000000000090000000000
00000000000000000000000000000000000000000000000000000000000000000000000000000000000000000007s7s00000000000000000000000000000000000000000000000000000000000000000000000000000000000000000000000000000000000000000000000
000000000000000000000000000000000000000000000000000000000000000007s700000077000000000000000s77s00000000000000000000000007h7000000000000000000000000000000440000000000sss0000000000000000000000000000000000000000000000
000000000000000000000000000000000000000000000000000000000000s700003400000000000000000000000343400000000000000000000000007770000000000000000000000000000000000033000000000000000000000000000000000000000000000000000000
0000000000000000000000000000000000000000000000000000000000034300000000003400000000000000000000000000000000000000000000007770000000000000000000000000000000000000000000000000000000000000000000000000000000000000000000
0000000000000000000000000000000000000000000000000077770300000000000000000000000000000343000000000000000000000000000000004440000000000000000000000000000003300000000000300000000000000000000000000000000000000000000000
000000000000000000000000000000000000000000s77s000043400000000000000000000000005000000000000000000000000000000000000000000000000000000sss000000000000000000000000000000000000000000000000000000000000000000000000000000
0000000000000000000000000000330000000000003343300000000000000077777000000000008003000000000000300040000000000000000043000000000000000000000000007777700000000033000000000040000000007000000000000000000000000000000000
0000000000000000000000077s03003050000330000000000000050000300007s70000000033008000003000003000000000004400000000330000000000000000040000000000007777700000003000030000000000000000077700000000000000000000000000000000
00000000666000000000660000000000800000066m000000006008000000000070000m66600000800m6600000000000000000000660000000000666m000000660000000000000m00777770000000000000000000m000000660777770000000000666600000000000000000
1111111111111111111111111111001111111111111111111111111100000111111111111111111111111111110000000000001111111111111111111111111110000011111111111111111111111000111111111111111111111111111111111111111111111111111111
1111111111111111111111111111001111111111111111111111111100000111111111111111111111111111110000000000001111111111111111111111111110000011111111111111111111111000111111111111111111111111111111111111111111111111111111