0000000000000000000000000000000000000
00000000000000w000wwwwwwwwwwwww000080
00000000000000w000wwwwwwwwwwwww000080
00000000000000w0000000000000000000080
00000000000000w0000000000000000000080
00000000000000w0000000000000000000080
00000000000000w0000070707070700000080
00000000000000w0000000000000000000080
00000000000000w0007070707070707000080
00000000000000w0000000000000000000080
00000000000000w0007070707070707000080
00000000000000w000wwwwwwwwwwwww000080
00000000000000w000wwwwwwwwwwwww000q80
00000000000000eeeeeeeeeeeeeeeeeeeeeee
test